XXXXXXXXXXXXXXXXXXXXXXXXXXXXXXXXXXXXXXXXXXXXXXXXXXXXXXXXXXXXXXXXXXXXXXXXXXXXXXXXXXXXXXXXXXXXXXXXXXXXXXXXXXXXXXXXXXXXXXXXXXXXXXXXXXXXXXXXXXXXXXXXXXXXXXXXXXXXXXXXXXXXXXXXXXXXXXXXXXXXXXXXXXXXXXXXXXXXXXXXXXXXXXXXXXXXXXXXXXXXXXXXXXXXXXXXXXXXXXXX
                                                                                                              ZZZZZ              Z                  Z             ZZZ                                            ZZ                 CCCCCC      
                                                ZZZZZZZ                Z                                       ZZZZ              ZZZZZZZZZZZZZZZZZZZZ              Z                                             ZZ                CC    CC     
                                                ZZZZZZ                 Z                                        ZZZ                     ZZZZZZ                     C                                                              CC      CC    
                                                ZZ                     Z                             Z     C     ZZ                                               C C                        ZZZZZ                                       CC     
                                                                       Z                            ZZZ     C     Z              CCCCCCCCCCCCCCCCCCCC            C   C                          ZZZ       ZZZZZZZ                       CC      
                                                        Z              Z                           ZZZZZ     C                   ZZZZZZZZZZZZZZZZZZZZ           C     C                       C   ZZ                                   CC       
                                    ZZ                 ZZ                     CCCCCCCCCCC         ZZZZZZZ     C                  CCCCCCCCCCCCCCCCCCCC          C   Z   C       ZZZZZ           C    Z     CCCCCC                      CC        
                                  ZZZZZZ             ZZZZ                                        ZZZZZZZZZ     C                                              C   ZZZ   C      ZZZZZ            C          CCCC      Z                          
                                ZZZZZZZZZZ         ZZZZZZ                     ZZZZZZZZZZZ       ZZZZZZZZZZZ     CCCCCCC                 ZZZZZZ               C   ZZZZZ   C                       C          CC      ZZ                CC        
                                                  ZZZZZZZ                                      ZZZZZZZZZZZZZ                     ZZZZZZZZZZZZZZZZZZZZ       C   ZZZZZZZ   C                                        ZZZ                CC        
XXXXXXXXXXXXXXXXXXXXXXXXXXXXXXXXXXXXXXXXXXXXXXXXXXXXXXXXXXXXXXXXXXXXXXXXXXXXXXXXXXXXXXXXXXXXXXXXXXXXXXXXXXXXXXXXXXXXXXXXXXXXXXXXXXXXXXXXXXXXXXXXXXXXXXXXXXXXXXXXXXXXXXXXXXXXXXXXXXXXXXXXXXXXXXXXXXXXXXXXXXXXXXXXXXXXXXXXXXXXXXXXXXXXXXXXXXXXXXXX
