XXXXXXXXXXXXXXXXXXXXXXXXXXXXXXXXXXXXXXXXXXXXXXXXXXXXXXXXXXXXXXXXXXXXXXXXXXXXXXXXXXXXXXXXXXXXXXXXXXXXXXXXXXXXXXXXXXXXXXXXXXXXXXXXXXXXXXXXXXXXXXXXXXXXXXXXXXXXXXXXXXXXXXXXXXXXXXXXXXXXXXXXXXXXXXXXXXXXXXXXXXXXXXXXXXXXXXXXXXXXXXXXXXXXXXXXXXXXXXXX
                                                                                                              ZZZZZ              ZZZZZZZZZZZZZZZZZZZZ             ZZZ                                            ZZ                 CCCCCC      
                                                ZZZZZZZ                Z                                       ZZZZ                                                Z                                             ZZ                CC    CC     
                                                ZZZZZZ                 Z                                        ZZZ              CCCCCCCCCCCCCCCCCCCC              C                                                              CC      CC    
                                                ZZ                     Z                             Z     C     ZZ                   Z       Z                   C C                        ZZZZZ                                       CC     
                                                                       Z                            ZZZ     C     Z                 ZZZZZ   ZZZZZ                C   C                          ZZZ       ZZZZZZZ                       CC      
                                                        Z              Z                           ZZZZZ     C                    ZZZ   ZZZZZ   ZZZZ            C     C                       C   ZZ                                   CC       
                                    ZZ                 ZZ                     CCCCCCCCCCC         ZZZZZZZ     C                  Z        Z         Z          C   Z   C       ZZZZZ           C    Z     CCCCCC                      CC        
                                  ZZZZZZ             ZZZZ                                        ZZZZZZZZZ     C                 CCCCCCCCCCCCCCCCCCCC         C   ZZZ   C      ZZZZZ            C          CCCC      Z                          
                                ZZZZZZZZZZ         ZZZZZZ                     ZZZZZZZZZZZ       ZZZZZZZZZZZ     CCCCCCC                                      C   ZZZZZ   C                       C          CC      ZZ                CC        
                                                  ZZZZZZZ                                      ZZZZZZZZZZZZZ                     ZZZZZZZZZZZZZZZZZZZZ       C   ZZZZZZZ   C                                        ZZZ                CC        
XXXXXXXXXXXXXXXXXXXXXXXXXXXXXXXXXXXXXXXXXXXXXXXXXXXXXXXXXXXXXXXXXXXXXXXXXXXXXXXXXXXXXXXXXXXXXXXXXXXXXXXXXXXXXXXXXXXXXXXXXXXXXXXXXXXXXXXXXXXXXXXXXXXXXXXXXXXXXXXXXXXXXXXXXXXXXXXXXXXXXXXXXXXXXXXXXXXXXXXXXXXXXXXXXXXXXXXXXXXXXXXXXXXXXXXXXXXXXXXX
