XXXXXXXXXXXXXXXXXXXXXXXXXXXXXXXXXXXXXXXXXXXXXXXXXXXXXXXXXXXXXXXXXXXXXXXXXXXXXXXXXXXXXXXXXXXXXXXXXXXXXXXXXXXXXXXXXXXXXXXXXXXXXXXXXXXXXXXXXXXXXXXXXXXXXXXXXXXXXXXXXXXXXXXXXXXXXXXXXXXXXXXXXXXXXXXXXXXXXXXXXXXXXXXXXXXXXXXXXXXXXXXXXXXXXXXXXXXXXXXX
                                  ZZ            ZZZZZ                                                    Z    Z                                       Z     Z     Z     Z     Z                                            Z          Z         
                                 ZZ              ZZZ                                                      Z  Z                                        Z     Z     Z     Z     Z       C    C    C    C    C    C            Z        Z          
                                ZZ                Z                                         ZZZZZ          ZZ             C    C    C    C    C       Z     Z           Z     Z                                              Z  CC  Z           
                                                                    C    C    C            Z                                                          Z           C           Z         C    C    C    C    C    C            CCCCCC            
     C    C    C    C    C                                            C    C                  CC                 ZZ         CC        CC                    C           C                                                                       
     C    C    C    C    C                                              C    C                    Z              ZZ              CC        CC         C           Z           C      C    C    C    C    C    C                                 
                                         Z               ZZZ                                 ZZZZZ                                                          Z     Z     Z                                                     CCCCCC            
                                        ZZZ             ZZZ                                                ZZ             C    C    C    C    C       Z     Z     Z     Z     Z        C    C    C    C    C    C            Z  CC  Z           
                                       ZZZZZ           ZZZ                                                Z  Z                                        Z     Z     Z     Z     Z                                             Z        Z          
                                      ZZZZZZZ         ZZZ                                                Z    Z                                       Z     Z     Z     Z     Z          C    C    C    C    C             Z          Z         
XXXXXXXXXXXXXXXXXXXXXXXXXXXXXXXXXXXXXXXXXXXXXXXXXXXXXXXXXXXXXXXXXXXXXXXXXXXXXXXXXXXXXXXXXXXXXXXXXXXXXXXXXXXXXXXXXXXXXXXXXXXXXXXXXXXXXXXXXXXXXXXXXXXXXXXXXXXXXXXXXXXXXXXXXXXXXXXXXXXXXXXXXXXXXXXXXXXXXXXXXXXXXXXXXXXXXXXXXXXXXXXXXXXXXXXXXXXXXXXX
