XXXXXXXXXXXXXXXXXXXXXXXXXXXXXXXXXXXXXXXXXXXXXXXXXXXXXXXXXXXXXXXXXXXXXXXXXXXXXXXXXXXXXXXXXXXXXXXXXXXXXXXXXXXXXXXXXXXXXXXXXXXXXXXXXXXXXXXXXXXXXXXXXXXXXXXXXXXXXXXXXXXXXXXXXXXXXXXXXXXXXXXXXXXXXXXXXXXXXXXXXXXXXXXXXXXXXXXXXXXXXXXXXXXXXXXXXXXXXXXX
                                                                                                                  Z                                                                                               Z                             
                                                CCCCCCC                Z                                          Z                                                                                              Z                CCC    CCC    
                                                CCCCCC                 Z                                          Z                                                C                                            Z                CCCCC  CCCCC   
                                                CC                     Z                             Z     C      Z                                               C C                        CCCCC                              CCCCCCCCCCCCCC  
                                                                       Z                            ZZZ     C     Z              ZZZZZZZZZZZZZZZZZZZZ            C   C                          CCC       ZZZZZZZ               CCCCCCCCCCCCCC  
                                                                       Z                           ZZZZZ     C                                                  C     C                       Z   CC                              CCCCCCCCCC    
                                    CC                 Z                      CCCCCCCCCCC         ZZZZZZZ     C                  CCCCCCCCCCCCCCCCCCCC          C   Z   C       CCCCC           Z    C     CCCCCC                   CCCCCCCC     
                                  CCCCCC               Z                                         ZZZZZZZZZ     C                                              C   ZZZ   C      CCCCC            Z          CCCC                     CCCCCC      
                                CCCCCCCCCC             Z                      ZZZZZZZZZZZ       ZZZZZZZZZZZ     C                ZZZZZZZZZZZZZZZZZZZZ        C   ZZZZZ   C     CCCCC             Z          CC                       CCCC       
                                                                                               ZZZZZZZZZZZZZ     CCCCCC                                     C   ZZZZZZZ   C                                          Z                CC        
XXXXXXXXXXXXXXXXXXXXXXXXXXXXXXXXXXXXXXXXXXXXXXXXXXXXXXXXXXXXXXXXXXXXXXXXXXXXXXXXXXXXXXXXXXXXXXXXXXXXXXXXXXXXXXXXXXXXXXXXXXXXXXXXXXXXXXXXXXXXXXXXXXXXXXXXXXXXXXXXXXXXXXXXXXXXXXXXXXXXXXXXXXXXXXXXXXXXXXXXXXXXXXXXXXXXXXXXXXXXXXXXXXXXXXXXXXXXXXXX
